#################################################
##       #####                        # B   #####
########  #### ### ##################### # ######
###### ## #### ### ###  #############      ######
######    #### ### ###     ########## #######   #
###### ####### ### ####### ########## ####### ###
######   ##### ###                    #######  ##
######## ##### #################### ######### ###
#A             ####################          B###
#################################################
