#################
#      #B ## #  #
##### ##  ##    #
##       ### ####
#  ##  ##### ####
#A##         ####
#################