###########################
#                         #
#                        B#
#                         #
#                         #
#                         #
#                         #
#                         #
#A                        #
###########################