#################
#      ##########
##### ## ########
##       B#######
#  ##############
#A###############
#################